########%####
########%$###
########%####
###%%%%%%####
###%$########
###%#########
###%%%%$#####
######%######
######%%%####
#######$%####
######%%%####
######%######
#####$%######
######*######

5
soldier soldier soldier warrior cyborg
5
warrior warrior warrior cyborg cyborg